0000000000000000000000000000000000000000000000000000000000000000000000000000000000000000
0000000000000000000000000000000000000022000000000000000000000000000000000000000000000000
0000000000000000000000000000000000000022000000000000000000000000000000000000000000000000
0000000000000000000000000000000000000000000000000000000000000000000000000000000000000000
0000000000000000000000000000000010000000000000000000000000000000000000000000000000000000
0000000000000000000000000000000000000000000000000000000000000000000000000000000000000000
0000000000000000000000000000000000000000000000000000000000000000000000000000000000000000
0000000000000000000000000000000000000000000000000000000000000000000000000000000000000000
0000000000000000000000000000000000000000000000000000000000000000000000000000000000000000
1111100111111111111111111111111111111111111001111111111111111111111111111111111111111111